XXXXXXXXXXXXXXXXXXXXXXXXXXX
XWWWWWWWWWWWWWWWWWWWWWWWWWX
XW+FFFFWFF+FWFFFFFFWFFCFFWX
XWFWFFFFWFFFFBWWWWFFFF+FFWX
XWFWF+FWWFWWWWWWWWWWFFFWFWX
XWBWFWFFFFFFFCFFFFFFFWFWFWX
XWFWFWFWFWWWWWWWWWFWFWFWFWX
XWBFFWFWFFFFF+FFFFFWFWFWFWX
XWFWFWFFFFFFFFFFFFFWFWFWFWX
XWFWFFFWFFFF+FFFFFBFFWFWFWX
XWFWFWFWFFWWWGWWWFFWFWFWFWX
XWFWFWFWFFWXXXXXWFFFFWFFFWX
DXFFFWFWFFW0X1X2WFFWFWFWFXD
XWFWFWFFFFWXXXXXWCFWFWFWFWX
XWFWFWFWFFWWWWWWWFFWFWFWFWX
XWFWFWFWFFFFFPFFFFFWFWFWFWX
XWCWFFFWFFFFFFFFFBFWFWFWFWX
XWFWFWFWFFFFF+FFFFFFFWFWFWX
XWFWBWFWFWWFWWWWWWFWFWFFFWX
XWFFFWFFFFFFFBFFFFFCFFFWFWX
XWFWFFFWWWWWWWFWWWWWFFFWFWX
XWFWFFFCFFWFF+FFFFFFFFFWFWX
XWFFFFWFFFFFFBFFFFFWFFFFFWX
XWWWWWWWWWWWWWWWWWWWWWWWWWX
XXXXXXXXXXXXXXXXXXXXXXXXXXX