XXXXXXXXXXXXXXXXXXXXXXXXXXX
XWWWWWWWWWWWWWWWWWWWWWWWWWX
XWFFFFFFWFFFFFFFFFWFFFFFFWX
XWFWWWWFWWFWWWWWFWWFWWWWFWX
XWFFFFCFWFFFFWFFFFWFFFFFFWX
XWFWWWFFWWWWFWFWWWWFFWWWFWX
XWBFFWFFF+FWFFFWFFFFFWF+FWX
XWWWFWFWFWFFFFFFFWFWFWFWWWX
XWFFFFFWWWWFWFWFWWWWFFFFBWX
XWFWWWFWFFFFWFWFFFFWFWWWFWX
XWFWFFFCFFWWWGWWWFFFFFFWFWX
XWFWFWWWWFWXXXXXWFWWWWFWFWX
DXFFFFFWFFW0X1X2WFFWFFFFFXD
XWFWWWFWFWWXXXXXWWFWFWWWFWX
XWFWFFFFFFWWWWWWWFF+FFFWFWX
XWFWFWWWWFFFFPFFFFWWWWFWFWX
XWFFFFFFWFWWWFWWWFWFFFFFFWX
XWWWFWWFFFFWFFFWFCFFWWFWWWX
XWFFFBFWWWWWWWWWWWWWFFFFFWX
XWFWWWFWFFFFFWFFBFFWFWWWFWX
XWFFWFFFFWFWFWFWFWFFFFWFFWX
XWWFWWWWWWFWFWFWFWWWWWWFWWX
XWFFFCFFFFFWFFFWFFFF+FFFFWX
XWWWWWWWWWWWWWWWWWWWWWWWWWX
XXXXXXXXXXXXXXXXXXXXXXXXXXX