XXXXXXXXXXXXXXXXXXXXXXXXXXX
XWWWWWWWWWWWWWWWWWWWWWWWWWX
XWFFF+FFBFFFFWFFF+FFFFBFFWX
XWFWFWWFWWWWFWFWWWWFWWWWFWX
XWFWFWWFWWWWFWFWWWWFWWWWFWX
XWFFF+FFFFFFFCFFF+FFFFFFFWX
XWFWWWWFWFWWWWWWWFWFWWWWFWX
XWFFCFFFWFFFFWFFFFWF+FCFFWX
XWWWWWWFWWWWFWFWWWWFWWWWWWX
XWXXXXWFWFFFFFFFFFWFWXXXXWX
XWXXXXWFWFWWWGWWWFWFWXXXXWX
XWWWWWWFWFW0XXXXWFWFWWWWWWX
DXXF+FFBFFWXXXX1WFFBFF+FXXD
XWWWWWWFWFW2XXXXWFWFWWWWWWX
XWXXXXW+WFWWWWWWWFWFWXXXXWX
XWXXXXWFWFFFFPFFFFWFWXXXXWX
XWWWWWWFWWWWFWFWWWWFWWWWWWX
XWFF+FFFWFFFFWF+FFWFF+FFFWX
XWFWWWWFWFWWWWWWWFWFWWWWFWX
XWFFCFFFFFFFFCFFFBFFFFCFFWX
XWFWWWWFWWWWFWFWWWWFWWWWFWX
XWFWWWWFWWWWFWFWWWWFWWWWFWX
XWFFFFF+FFBFFWFFFFF+FFFFFWX
XWWWWWWWWWWWWWWWWWWWWWWWWWX
XXXXXXXXXXXXXXXXXXXXXXXXXXX